NO ./sprites/wood2.xpm
EA ./sprites/wood2.xpm
SO ./sprites/wood2.xpm
WE ./sprites/door_close.xpm

C 255,0,255
F 0,255,0

111111111111111
111111000111111
111110000011111
111100000001111
111000000000111
110000000000011
100001111100001
110000111000011
111000010000111
1111000D0001111
1111100S0111111
111111000111111
111111111111111
