NO ./sprites/wood.xpm
EA ./sprites/wood.xpm
SO ./sprites/wood.xpm
WE ./sprites/wood.xpm

C 255,0,255
F 0,255,0

11111111111111
10000000000001
10000000000001
1000000000000111111111111111
1000000000000110000000000001
1000000000000110000000000001
1000000N00000000000000000001
1000000000000110000000000001
1000000000000110000000000001
1000000000000110000000000001
1000000000000111111111111111
11111111111111
