NO ./sprites/wood.xpm
EA ./sprites/wood.xpm
SO ./sprites/wood.xpm
WE ./sprites/wood.xpm

F 164,169,20

1111111111111111111
10W1001001001000001
1011000001000001001
1001001001111101111
1001111000001001001
1000000000000001001
1001111111111001001
1111000000000001011
1000000001D00000001
1111111111111111111
